out path		apk path		AndroidManifest
out/target/product/qssi/product/app/CalendarGoogle/CalendarGoogle.apk	./vendor/partner_gms/apps/CalendarGoogle/Android.mk	false
out/target/product/qssi/product/app/DeskClockGoogle/DeskClockGoogle.apk	./vendor/partner_gms/apps/DeskClockGoogle/Android.mk	false
out/target/product/qssi/product/app/Drive/Drive.apk	./vendor/partner_gms/apps/Drive/Android.mk	false
out/target/product/qssi/product/app/Gmail2/Gmail2.apk	./vendor/partner_gms/apps/Gmail2/Android.mk	false
out/target/product/qssi/product/app/GoogleContactsSyncAdapter/GoogleContactsSyncAdapter.apk	./vendor/partner_gms/apps/GoogleContactsSyncAdapter/Android.mk	false
out/target/product/qssi/product/app/Maps/Maps.apk	./vendor/partner_gms/apps/Maps/Android.mk	false
out/target/product/qssi/product/app/Photos/Photos.apk	./vendor/partner_gms/apps/Photos/Android.mk	true
out/target/product/qssi/product/app/Videos/Videos.apk	./vendor/partner_gms/apps/Videos/Android.mk	true
out/target/product/qssi/product/app/YouTube/YouTube.apk	./vendor/partner_gms/apps/YouTube/Android.mk	true
out/target/product/qssi/product/app/YTMusic/YTMusic.apk	./vendor/partner_gms/apps/YTMusic/Android.mk	true
out/target/product/qssi/product/priv-app/CarrierServices/CarrierServices.apk	./vendor/partner_gms/apps/CarrierServices/Android.mk	true
out/target/product/qssi/product/priv-app/GmsCore/GmsCore.apk	./vendor/partner_gms/apps/GmsCore/Android.mk	true
out/target/product/qssi/product/priv-app/GooglePartnerSetup/GooglePartnerSetup.apk	./vendor/partner_gms/apps/GooglePartnerSetup/Android.mk	true
out/target/product/qssi/product/priv-app/Phonesky/Phonesky.apk	./vendor/partner_gms/apps/Phonesky/Android.mk	true
out/target/product/qssi/product/priv-app/Velvet/Velvet.apk	./vendor/partner_gms/apps/Velvet/Android.mk	true
out/target/product/qssi/product/priv-app/Wellbeing/Wellbeing.apk	./vendor/partner_gms/apps/Wellbeing/Android.mk	true
out/target/product/qssi/system/app/arda/arda.apk	./vendor/tct/qualcomm/cellular/arda/Android.mk	true
out/target/product/qssi/system/app/Bluetooth/Bluetooth.apk	./packages/apps/Bluetooth/Android.bp	true
out/target/product/qssi/system/app/com.tct.aio/com.tct.aio.apk	./vendor/tct/aio_custom/aios/aiom/proxy/java/Android.mk	true
out/target/product/qssi/system/app/GooglePay/GooglePay.apk	./vendor/partner_gms/apps/GooglePay/Android.mk	true
out/target/product/qssi/system/app/TelecomRFM/TelecomRFM.apk	./vendor/tct/qualcomm/cellular/TctRFM/Android.mk	true
out/target/product/qssi/system/app/WLANTestMode/WLANTestMode.apk	./development/apps/WLANTestMode/Android.mk	true
out/target/product/qssi/system_ext/app/atfwd/atfwd.apk	./vendor/qcom/proprietary/commonsys/telephony-apps/ATFwd/Android.bp	true
out/target/product/qssi/system_ext/app/colorservice/colorservice.apk	./vendor/qcom/proprietary/commonsys/display/display-sdk/framework/service/Android.mk	true
out/target/product/qssi/system_ext/app/datastatusnotification/datastatusnotification.apk	./vendor/qcom/proprietary/commonsys/telephony-apps/DataStatusNotification/Android.bp	true
out/target/product/qssi/system_ext/app/DeviceStatisticsService/DeviceStatisticsService.apk	./vendor/qcom/proprietary_qssi/prebuilt_HY11/target/product/qssi/Android.mk	true
out/target/product/qssi/system_ext/app/embms/embms.apk	./vendor/qcom/proprietary_qssi/prebuilt_HY11/target/product/qssi/Android.mk	true
out/target/product/qssi/system_ext/app/imssettings/imssettings.apk	./vendor/qcom/proprietary/commonsys/telephony-apps/ims/settings/Android.bp	true
out/target/product/qssi/system_ext/app/ModemTestMode/ModemTestMode.apk	./vendor/qcom/proprietary/commonsys/telephony-apps/ModemTestMode/Android.bp	true
out/target/product/qssi/system_ext/app/QtiTelephonyService/QtiTelephonyService.apk	./vendor/qcom/proprietary/commonsys/telephony-apps/QtiTelephonyService/Android.bp	true
out/target/product/qssi/system_ext/app/remotesimlockservice/remotesimlockservice.apk	./vendor/qcom/proprietary_qssi/prebuilt_HY11/target/product/qssi/Android.mk	true
out/target/product/qssi/system_ext/app/uimgbaservice/uimgbaservice.apk	./vendor/qcom/proprietary_qssi/prebuilt_HY11/target/product/qssi/Android.mk	true
out/target/product/qssi/system_ext/app/uimremoteclient/uimremoteclient.apk	./vendor/qcom/proprietary/commonsys/uim_remote_service/client/service/Android.mk	true
out/target/product/qssi/system_ext/app/uimremoteserver/uimremoteserver.apk	./vendor/qcom/proprietary/commonsys/uim_remote_service/server/service/Android.mk	true
out/target/product/qssi/system_ext/app/xdivert/xdivert.apk	./vendor/qcom/proprietary/commonsys/telephony-apps/xdivert/Android.bp	true
out/target/product/qssi/system_ext/priv-app/com.qualcomm.location/com.qualcomm.location.apk	./vendor/qcom/proprietary/commonsys/gps/framework/Android.mk	true
out/target/product/qssi/system_ext/priv-app/dpmserviceapp/dpmserviceapp.apk	./vendor/qcom/proprietary_qssi/prebuilt_HY11/target/product/qssi/Android.mk	true
out/target/product/qssi/system_ext/priv-app/GoogleFeedback/GoogleFeedback.apk	./vendor/partner_gms/apps/GoogleFeedback/Android.mk	true
out/target/product/qssi/system_ext/priv-app/GoogleServicesFramework/GoogleServicesFramework.apk	./vendor/partner_gms/apps/GoogleServicesFramework/Android.mk	true
out/target/product/qssi/system_ext/priv-app/ims/ims.apk	./vendor/qcom/proprietary/commonsys/telephony-apps/ims/Android.bp	true
out/target/product/qssi/system_ext/priv-app/qcrilmsgtunnel/qcrilmsgtunnel.apk	./vendor/qcom/proprietary/commonsys/qcrilOemHook/Android.bp	true
out/target/product/qssi/system_ext/priv-app/SetupWizard/SetupWizard.apk	./vendor/partner_gms/apps/SetupWizard/Android.mk	true
out/target/product/qssi/system_ext/priv-app/StorageManager/StorageManager.apk	./packages/apps/StorageManager/Android.mk	true
out/target/product/qssi/system/priv-app/Cloud/Cloud.apk	./vendor/3rd_apps/VZW-Operators/apps/Cloud/Android.mk	true
out/target/product/qssi/system/priv-app/DigitalSecure/DigitalSecure.apk	./vendor/3rd_apps/VZW-Operators/apps/DigitalSecure/Android.mk	true
out/target/product/qssi/system/priv-app/FusedLocation/FusedLocation.apk	./frameworks/base/packages/FusedLocation/Android.bp	true
out/target/product/qssi/system/priv-app/Ignite/Ignite.apk	./vendor/3rd_apps/VZW-Operators/apps/Ignite/Android.mk	true
out/target/product/qssi/system/priv-app/ImsPlugin/ImsPlugin.apk	./vendor/tct/packages/apps/ImsPlugin/Android.mk	true
out/target/product/qssi/system/priv-app/JoySystemUI/JoySystemUI.apk	./vendor/tct/apps/JoySystemUI/Android.mk	true
out/target/product/qssi/system/priv-app/MVM/MVM.apk	./vendor/3rd_apps/VZW-Operators/apps/MVM/Android.mk	true
out/target/product/qssi/system/priv-app/MVS/MVS.apk	./vendor/3rd_apps/VZW-Operators/apps/MVS/Android.mk	true
out/target/product/qssi/system/priv-app/StatementService/StatementService.apk	./frameworks/base/packages/StatementService/Android.bp	true
out/target/product/qssi/system/priv-app/TctGallery/TctGallery.apk	./vendor/tct/apps/Gallery/Android.mk	true
out/target/product/qssi/system/priv-app/TctGcsPhone/TctGcsPhone.apk	./vendor/tctalone/apps/TctTelehonyApps/Android.mk	true
out/target/product/qssi/system/priv-app/TctSettings/TctSettings.apk	./vendor/tctalone/apps/TctSettingsApp/Android.mk	true
out/target/product/qssi/system/priv-app/TctSetupWizardVZW/TctSetupWizardVZW.apk	./vendor/tctalone/apps/TctSetupwizardVZW/Android.mk	true
out/target/product/qssi/system/priv-app/TctWeather/TctWeather.apk	./vendor/tct/apps/Weather/Android.mk	true
out/target/product/qssi/system/priv-app/Telecom/Telecom.apk	./packages/services/Telecomm/Android.bp	true
out/target/product/qssi/system/priv-app/TeleService/TeleService.apk	./packages/services/Telephony/Android.bp	true
out/target/product/qssi/system/priv-app/VZMessage/VZMessage.apk	./vendor/3rd_apps/VZW-Operators/apps/VZMessage/Android.mk	true
out/target/product/qssi/system/removable-app/Duo/Duo.apk	./vendor/partner_gms/apps/Duo/Android.mk	true
[Android.bp true] numbers:13
[Android.bp flase] numbers:0
[Android.mk true] numbers:42
[Android.mk false] numbers:6
